###########################################
#                                         #
#                                         #
#       R                  F              #
#                                         #
                                           
#              F                       ####
#                                      #  #
#                                      # C#
#                                      #  #
###########################################