###########################################
#R        #                  #           C#
# ##      #                  #         ## #
# #                 #                   # #
#                   #                     #
 F       R          F         R          F 
#                   #                     #
# #                 #                   # #
# ##        #                 #        ## #
#C          #                 #          R#
###########################################