###########################################
#                                         #
#    R   F   F   F   F                    #
#                                         #
#                                         #
                                C    R     
#                                         #
#                                         #
######                                    #
#C  R#                                    #
###########################################