###########################################
#                                         #
#                                         #
#               #####                     #
#               # R #                     #
                #   #                      
#               # C #                     #
#               #####                     #
#                                         #
#                                       F #
###########################################