###########################################
#                                         #
#                                         #
#                                         #
#                                         #
     R     C                               
#                                         #
#                                         #
#                                         #
#                                       F #
###########################################